// Castle Fireworks
// Level 1-3
// [x], [y], [targetX], [targetY], [xSpeed], [ySpeed], [fireworkNumber], [delay]
// Fireworks: 19
// Target Score: 36,000

@500,550,480,50,5,-5,1,3000@

@240,500,260,100,5,-5,2,2000@

@220,550,240,50,5,-5,3,3000@

@150,550,140,50,-5,-5,1,2000@

@200,575,220,250,5,-5,1,2000@

@240,550,220,50,-5,-5,3,2000@

@100,425,120,175,5,-5,1,2000@

@200,550,180,50,-5,-5,2,2000@

@320,450,330,150,5,-5,1,1000@

@340,475,350,125,5,-5,3,2000@

@360,500,370,100,5,-5,1,1000@

@200,525,220,75,5,-5,2,3000@

@300,525,310,75,5,-5,1,2000@

@450,500,460,100,5,-5,3,3000@

@360,520,340,80,-5,-5,3,1000@

@320,500,310,100,-5,-5,2,2000@

@340,550,360,50,5,-5,1,1000@

@400,525,380,75,-5,-5,3,1000@

@380,550,360,50,-5,-5,2,2000@